CorrectToneFilter	KEYWORD1
OctaveShift	KEYWORD1
OneKeySynthesizerFilter	KEYWORD1
ScoreSrc	KEYWORD1
SDSeekSink	KEYWORD1
SDSink	KEYWORD1
SFZSink	KEYWORD1
ToneFilter	KEYWORD1
VoiceCapture	KEYWORD1
NullFilter	KEYWORD1
BaseFilter	KEYWORD1
Filter	KEYWORD1
YuruInstrumentConfig	KEYWORD1
YuruInstrumentConsole	KEYWORD1

begin	KEYWORD2
update	KEYWORD2
isAvailable KEYWORD2
getParam    KEYWORD2
setParam    KEYWORD2
sendNoteOff	KEYWORD2
sendNoteOn	KEYWORD2

PARAMID_OCTAVE_SHIFT	LITERAL1
PARAMID_NUMBER_OF_SCORES	LITERAL1
PARAMID_SCORE	LITERAL1
PARAMID_SCORE_NAME	LITERAL1
PARAMID_STATUS	LITERAL1
PARAMID_SCORE_NAME	LITERAL1
PARAMID_OFFSET	LITERAL1
PARAMID_LOOP	LITERAL1
PARAMID_TONE	LITERAL1
PARAMID_MIC_GAIN	LITERAL1
PARAMID_INPUT_LEVEL	LITERAL1
PARAMID_RECORDING	LITERAL1
PARAMID_ACTIVE_LEVEL	LITERAL1
PARAMID_PLAY_BUTTON_ENABLE	LITERAL1
PARAMID_SCALE	LITERAL1
PARAMID_MIN_NOTE	LITERAL1
PARAMID_MAX_NOTE	LITERAL1
PARAMID_CORRECT_FRAMES	LITERAL1
PARAMID_SUPPRESS_FRAMES	LITERAL1
PARAMID_KEEP_FRAMES	LITERAL1
PARAMID_VOLUME_METER	LITERAL1
PARAMID_MONITOR_ENABLE	LITERAL1
PARAMID_OUTPUT_LEVEL	LITERAL1
